0,1,1,1,1,1,1,1,1,1,1,1,1,1,1,1,1,1,1,1,1,1,1,1,1,1,1,2
10,10,10,10,10,10,10,10,10,10,10,10,10,10,10,10,10,10,10,10,10,10,10,10,10,10,10,11
5,6,10,33,10,4,5,5,5,5,5,5,5,5,5,5,5,5,5,5,5,5,5,44,10,4,5,5
9,10,10,42,10,10,10,10,10,10,10,10,10,10,10,10,10,10,10,10,10,10,10,42,10,10,10,11
9,10,43,48,5,5,5,5,5,5,5,5,5,44,10,10,4,5,5,5,5,44,10,42,10,10,10,11
9,10,42,10,10,10,10,10,10,10,10,10,10,42,10,10,10,10,10,10,10,42,10,49,5,6,10,11
9,10,42,10,43,5,44,10,4,5,44,10,10,52,5,5,5,5,44,10,10,42,10,42,10,10,10,11
9,10,51,10,51,10,42,10,10,10,42,10,10,10,10,10,10,10,42,10,10,42,10,42,10,43,5,5
9,10,10,10,10,10,42,10,33,10,42,10,10,43,5,5,6,10,42,10,10,42,10,42,10,51,10,11
5,5,5,5,5,5,53,10,42,10,42,10,10,42,10,10,10,10,42,10,10,42,10,42,10,10,10,11
9,10,10,10,10,10,10,10,42,10,42,10,10,42,10,10,4,5,42,10,10,42,10,49,5,5,5,5
9,10,10,10,10,10,10,10,42,10,42,10,10,42,10,10,10,10,42,10,10,42,10,42,10,10,10,11
9,10,43,5,5,5,5,5,48,5,39,10,43,49,5,5,5,5,53,10,10,42,10,42,10,33,10,11
9,10,42,10,10,10,10,10,10,10,42,10,42,10,10,10,10,10,10,10,10,42,10,52,5,53,10,11
9,10,42,10,43,5,5,6,10,10,42,10,42,10,43,5,5,5,5,5,5,42,10,10,10,10,10,11
9,10,42,10,42,10,10,10,10,10,42,10,42,10,42,10,10,10,10,10,10,52,5,5,5,5,5,5
9,10,42,10,42,10,43,5,5,5,50,10,42,10,51,10,10,33,10,10,10,10,10,10,10,10,10,11
9,10,42,10,42,10,42,10,10,10,42,10,42,10,10,10,10,42,10,10,10,10,10,10,10,10,10,11
9,10,42,10,42,10,42,10,33,10,42,10,52,5,5,5,5,48,5,5,5,5,40,5,5,6,10,11
9,10,42,10,42,10,42,10,42,10,42,10,10,10,10,10,10,10,10,10,10,10,42,10,10,10,10,11
9,10,52,5,53,10,52,5,53,10,42,10,10,4,5,5,5,40,5,5,6,10,42,10,10,10,10,11
9,10,10,10,10,10,10,10,10,10,42,10,10,10,10,10,10,42,10,10,10,10,42,10,10,33,10,11
9,10,10,10,10,10,10,10,10,10,42,10,10,10,10,10,10,42,10,10,10,10,42,10,10,42,10,11
5,5,5,5,5,5,5,5,5,5,48,5,5,5,6,10,10,42,10,10,4,5,39,10,10,52,5,5
9,10,10,10,10,10,10,10,10,10,10,10,10,10,10,10,10,42,10,10,10,10,42,10,10,10,10,10
18,19,19,19,19,19,19,19,19,19,19,19,19,19,19,19,19,42,19,19,19,19,42,19,19,19,19,20
